1,S,1,1,1,1,1,1,1,1,1,1,1,1,1,1,1,1,1,1,1,1,1,1
1,0,1,0,0,0,0,0,O,T,O,0,1,C,0,0,1,1,0,O,C,T,1,1
1,0,1,0,0,1,1,1,O,O,O,1,1,0,1,1,1,0,0,C,O,O,0,1
1,C,1,1,0,0,0,0,1,0,1,1,1,0,1,0,1,0,1,1,1,1,O,1
1,O,0,1,0,1,1,1,1,0,1,0,1,0,0,M,0,0,0,O,T,1,C,1
1,0,0,1,0,1,0,1,0,0,1,0,0,0,1,0,1,0,1,O,1,1,0,1
1,0,1,1,0,1,0,1,1,0,1,1,1,0,1,0,1,0,1,O,T,1,O,1
1,0,0,0,0,0,0,0,0,O,0,0,0,0,1,0,1,0,1,0,1,1,T,1
1,0,1,1,0,1,1,1,1,1,1,1,1,1,1,0,1,0,1,1,1,1,1,1
1,0,0,1,0,D,0,0,0,0,0,0,0,0,1,T,1,0,0,0,1,T,1,1
1,0,1,1,0,1,0,1,1,0,1,1,1,1,1,1,1,0,1,1,1,0,0,1
1,0,1,0,0,1,0,0,1,0,C,0,0,0,1,C,1,1,0,0,1,1,C,1
1,O,1,1,0,1,0,1,1,1,1,1,1,0,1,0,1,1,1,0,1,O,0,1
1,O,0,1,0,1,0,1,C,1,1,C,1,0,0,0,0,0,1,0,1,0,1,1
1,T,1,1,C,1,0,O,0,0,O,0,O,0,0,1,1,0,0,0,0,0,O,1
1,1,1,1,1,1,1,1,1,1,1,1,1,1,1,1,1,1,1,1,1,1,E,1