1,S,1,1,1,1,1,1,1,1,1,1,1,1,1,1,1,1,1,1,1,1,1,1
1,C,C,C,C,C,C,1,1,1,1,1,1,1,1,1,1,1,1,1,1,1,1,1
1,1,1,1,1,1,C,1,1,1,1,1,1,1,1,1,1,1,1,1,1,1,1,1
1,1,1,1,1,1,C,1,1,1,0,0,0,0,0,0,0,0,0,1,1,1,1,1
1,1,1,1,1,1,C,1,O,0,0,1,1,1,1,1,1,1,0,1,0,0,0,1
1,1,C,C,C,C,C,1,O,1,1,1,1,1,1,1,1,1,0,1,0,1,0,1
1,1,C,1,1,1,1,1,O,O,O,O,O,1,1,1,1,1,0,1,0,1,0,1
1,1,C,1,1,1,1,1,1,1,1,1,O,1,1,1,1,1,0,1,0,1,0,1
1,1,C,1,1,1,1,1,1,1,1,1,O,1,1,1,1,1,0,1,0,1,0,1
1,1,C,C,C,C,C,C,C,C,C,C,C,1,1,1,1,1,C,0,0,1,0,1
1,1,1,1,1,1,1,1,1,1,1,1,1,1,1,1,1,1,1,1,1,1,0,1
1,1,1,1,1,1,1,1,1,1,1,1,1,0,0,0,0,0,0,0,0,0,0,1
1,1,1,1,1,1,1,1,1,1,1,1,1,0,1,1,1,1,1,1,1,1,1,1
1,1,1,1,1,1,1,1,1,1,1,1,1,0,1,1,1,1,1,1,1,1,1,1
1,1,1,1,1,1,1,1,1,1,1,1,1,0,0,0,0,0,0,0,0,0,0,1
1,1,1,1,1,1,1,1,1,1,1,1,1,1,1,1,1,1,1,1,1,1,E,1